1111111111
1010001031
1010101011
1000100001
1111111111
